# lvlwidth 19
# lvlheight 19
# bgcolor 0 0 0
# edgelightcolor 0 0 255
# edgeshadowcolor 0 0 255
# fillcolor 0 0 0
# pelletcolor 255 255 255
# fruittype 1

# startleveldata
120  21 120  21 120  21 120  21 120  21 120  21 120  21 120  21 120  21 120
20    2   2   2   2   2   2   2   2   2   2   2   2   2   2   2   2   2  20
120   2 120   2 120   2 120   2 120   2 120   2 120   2 120   2 120   2 120
20    2   2   3   2   2   2   2   2   2   2   2   2   2   2   3   2   2  20
120   2 120   2 120   2 120   2 120   2 120   2 120   2 120   2 120   2 120
20    2   2   2   2   2   2   2   2   2   2   2   2   2   2   2   2   2  20
120   2 120   2 120   2 120   0 120   0 120   0 120   2 120   2 120   2 120
20    2   2   2   2   2   0   0   0  10   0   0   0   2   2   2   2   2  20
120   2 120   2 120   2 107 133 112   1 111 133 108   2 120   2 120   2 120
20    2   2   2   2   2 131 132  11  12  13 131 132   2   2   2   2   2  20
120   2 120   2 120   2 105 130 100 100 100 130 106   2 120   2 120   2 120
20    2   2   2   2   2   2   2   2   4   2   2   2   2   2   2   2   2  20
120   2 120   2 120   2 120   2 120   2 120   2 120   2 120   2 120   2 120
20    2   2   2   2   2   2   2   2   2   2   2   2   2   2   2   2   2  20
120   2 120   2 120   2 120   2 120   2 120   2 120   2 120   2 120   2 120
20    2   2   3   2   2   2   2   2   2   2   2   2   2   2   3   2   2  20
120   2 120   2 120   2 120   2 120   2 120   2 120   2 120   2 120   2 120
20    2   2   2   2   2   2   2   2   2   2   2   2   2   2   2   2   2  20
120  21 120  21 120  21 120  21 120  21 120  21 120  21 120  21 120  21 120
# endleveldata

# sprites
